+--+--+--+--+
|           |
+  +--+  +  +
|  |     |  |  +--+----+
+  +  +--+--+  |       |
|  |        |  +  +----+
+  +--+--+  +--|  |     /--+----+
|        |      x +    /        |
+--+--+--+--+-|   |   |   |    g|
      +---+   +   +   +   +-----+
      |   |   |   |   |         |
      +   +---+   +---+   +--+  +
      |                   |  |  |
      +---+---+---+---+---+  +--+