+--+--+--+--+
|           |
+  +--+  +  +
|  |     |  |     
+  +  _______ 
|  |        l
+  +______  l
|        l  l
+--+--+--____
      

